,,,,2,9,,29,,,,,,,
73,23,27,39,4,31,25,51,77,,,,,,
,,,,10,70,41,,,,,,,,
106,14,40,,,,49,,,24,26,37,105,,
64,15,0,,,,,,98,74,75,99,48,54,
1,17,71,21,62,8,61,,97,96,47,,55,35,16
44,58,60,33,11,6,19,,100,45,68,50,72,20,
69,34,66,76,,,,,107,56,43,59,3,113,114
,,,,,,,,,,,104,,,
88,87,90,,,,32,30,42,,,93,92,,112
85,103,80,81,82,,52,5,18,,53,36,67,101,111
84,83,91,86,89,,38,12,46,,63,57,65,102,110
,,,,,,,,,108,95,13,7,78,
,,,,,,,,,109,94,28,79,22,
